1 1 1 1 1 1 1 1 1 1
1 1 1 1 1 1 1 0 0 1
1 1 0 0 0 1 0 0 1 1
1 0 0 1 0 1 0 1 1 1
1 1 0 1 0 1 1 1 1 1
0 0 0 1 0 0 0 1 1 1
1 1 0 0 1 1 0 0 1 1
1 1 0 1 0 1 1 0 0 1
0 0 0 0 0 0 1 1 0 E
1 1 0 1 1 1 1 1 1 1


EXIT = (8,9)
ENTRANCE = (5,0) (8,0) (9,2)

en= 9,2
